###############
#     x@      #
#h            #
#h            #
#v            #
# ##### ##### #
# #***   ***# #
# #r3a# #*2a# #
# ##### ##### #
#      h     v#
#             #
#    v    h   #
#####     #####
#*ha   1   ah*#
###############
