###############
#            @#
#   ###########
#        h    #
#0      a#    #
############# #
# #*** h ***#h#
#       ##### #
#v      ##### #
##       raaa #
#h #### #######
#            h#
#        h#####
#*********v**t#
###############
