###############
#f****        #
#h            #
#      #    # #
#a         h# #
#    v      # #
#          h# #
#0  v  #    # #
#@          # #
###v   #    # #
#             #
#            h#
##     h#######
#            *#
###############
