###############
#      @     0#
#v            #
#v            #
#v            #
# #############
# #*** h ***#h#
#             #
####### ##### #
#        raaa #
#  ############
#  hhhhhh    f#
#####     #####
#*************#
###############
