###############
#   v v v     #
#             #
# #    #    #@#
#a#        h# #
#*#h        ###
#a#        h#a#
#*#h   #    #*#
# #        h#a#
###h   #    # #
#0            #
#             #
########      #
#t**a        *#
###############
