###############
#      @      #
#             #
# #    #    ###
#r#        h#2#
#*#h        #*#
#a#        h#e#
#*#h   #    #*#
#1#        h#a#
###h   #    # #
#             #
#             #
####### #######
#faraaaxaaara*#
###############
