###############
#@            #
#########     #
#        h    #
#       #    0#
# #############
# #*** h ***#h#
# #####       #
#v      ##### #
##       raaa #
#h ############
# h          f#
#         #####
#*************#
###############
